..........................PP
..........................PP
..........................PP
..........................PP
..........................PP
..........................PP
..........................PP
..........................PP
..........................PP
..........................PP
.........ppPPppppp........PP
.......CC...P.............PP
............P.............PP
.S...p......xxa.a.....m...PP
GGGGGGggggggggggggggggggggPP